11111211111111111211111
12222222222122222222221
14111211112121111211141
12111211112121111211121
12222222222222222222221
12111211211111211211121
12222211222122211222221
11111211112121111211111
11111212222222221211111
11111212111011121211111
22222222100000122222222
11111212111111121211111
11111212222222221211111
11111212111111121211111
12222222222122222222221
14111211112121111211141
12211222222222222211221
11211212111111121211211
12222212222122221222221
12111111112121111111121
12222222222222222222221
11111111112121111111111